*********************************************************
*                                                       *
*    ****                                               *
*    *  *                                               *
*    *  *                                               *
*********************************************************
*                                                       *
*                                                       *
*        ******                                       ***
*       *      *                                  ***** *
*      *        *                                 *   * *
*      *        *                                 *   * *
*      *  ++++  *       Z      Z                  *   ***
*      *  ++++  *                                 ***** *
*      **      **          Z                      *******
*      **********     \         /                       *
*                      \       /                        *
*                       \     /                         *
*                        \   /                          *
*                         \ /                           *
*                          @                            *
*                                                       *
*                                                       *
*******************__________________********************
