
************************
* -------| | |---------*
* _______ ___ _________*
*                      *
*          Z           *
*        \   /         *
*         \ /          *
*          @           *
*        \             *
**********   ***********
