************************
*                ****  *
*                *  *  *
* ******         *  *  *
***    *****************
* *    *               *
* *    *               *
* *    *               *
* ******          Z    *
* ******       \     / *
* *    *        \   /  *
* *    *         \ /   *
* *    *          @    *
* *    *        \      *
* ******         \     *
******************  ****
