***********__***********
*_________|ZZ|_________*
*        |____|        *
*                      *
*      \+------/       *******
*       \     /|       |______
*       +\---/-+               
*         \ /          *******
*          @           *
*       \              *
*        \             *
**********   ***********

